R 1920 1080
NO ./textures/bluestone.xpm
SO ./textures/wall_4.xpm
WE ./textures/wood.xpm
EA ./textures/wall_3.xpm

S ./path_to_the_sprite_texture
F 0,255,255
C 0,255,200

        1111111111111111111111111
        1000000000110000000000001
        1011000001110000002000001
        1001000000000000000000001
111111111011000001110000000000001
100000000011000001110111100011111
11110111111111011100000010001    
11110111111111011101010010001    
11000000110101011100000010001    
10002000000000000000000000001    
10000000000000000000000000001    
11000001110101011100000000N0111  
11110111 1110101 101111000001    
11111111 1111111 111111111111    